SLR closure table
Goto	Kernel	State	Closure
{PROGRAM' -> .PROGRAM}	0	{PROGRAM' -> .PROGRAM; PROGRAM -> .Delim KwStatements STATEMENTLIST Delim KwAlgorithm COMMANDLIST}
goto(0, PROGRAM)	{PROGRAM' -> PROGRAM.}	1	{PROGRAM' -> PROGRAM.}
goto(0, Delim)	{PROGRAM -> Delim.KwStatements STATEMENTLIST Delim KwAlgorithm COMMANDLIST}	2	{PROGRAM -> Delim.KwStatements STATEMENTLIST Delim KwAlgorithm COMMANDLIST}
goto(2, KwStatements)	{PROGRAM -> Delim KwStatements.STATEMENTLIST Delim KwAlgorithm COMMANDLIST}	3	{PROGRAM -> Delim KwStatements.STATEMENTLIST Delim KwAlgorithm COMMANDLIST; STATEMENTLIST -> .STATEMENT STATEMENTLIST; STATEMENTLIST -> .STATEMENT; STATEMENT -> .Var Delim VARTYPE}
goto(3, STATEMENTLIST)	{PROGRAM -> Delim KwStatements STATEMENTLIST.Delim KwAlgorithm COMMANDLIST}	4	{PROGRAM -> Delim KwStatements STATEMENTLIST.Delim KwAlgorithm COMMANDLIST}
goto(3, STATEMENT)	{STATEMENTLIST -> STATEMENT.STATEMENTLIST; STATEMENTLIST -> STATEMENT.}	5	{STATEMENTLIST -> STATEMENT.STATEMENTLIST; STATEMENTLIST -> STATEMENT.; STATEMENTLIST -> .STATEMENT STATEMENTLIST; STATEMENTLIST -> .STATEMENT; STATEMENT -> .Var Delim VARTYPE}
goto(3, Var)	{STATEMENT -> Var.Delim VARTYPE}	6	{STATEMENT -> Var.Delim VARTYPE}
goto(4, Delim)	{PROGRAM -> Delim KwStatements STATEMENTLIST Delim.KwAlgorithm COMMANDLIST}	7	{PROGRAM -> Delim KwStatements STATEMENTLIST Delim.KwAlgorithm COMMANDLIST}
goto(5, STATEMENTLIST)	{STATEMENTLIST -> STATEMENT STATEMENTLIST.}	8	{STATEMENTLIST -> STATEMENT STATEMENTLIST.}
goto(5, STATEMENT)	{STATEMENTLIST -> STATEMENT.STATEMENTLIST; STATEMENTLIST -> STATEMENT.}	5	 
goto(5, Var)	{STATEMENT -> Var.Delim VARTYPE}	6	 
goto(6, Delim)	{STATEMENT -> Var Delim.VARTYPE}	9	{STATEMENT -> Var Delim.VARTYPE; VARTYPE -> .KwInteger; VARTYPE -> .KwReal}
goto(7, KwAlgorithm)	{PROGRAM -> Delim KwStatements STATEMENTLIST Delim KwAlgorithm.COMMANDLIST}	10	{PROGRAM -> Delim KwStatements STATEMENTLIST Delim KwAlgorithm.COMMANDLIST; COMMANDLIST -> .COMMAND COMMANDLIST; COMMANDLIST -> .COMMAND; COMMAND -> .ASSIGNCMD; COMMAND -> .INCMD; COMMAND -> .OUTCMD; COMMAND -> .CONDITIONCMD; COMMAND -> .REPEATCMD; COMMAND -> .SUBALGORITHM; ASSIGNCMD -> .KwAssign ARITHMETICEXPRESSION KwTo Var; INCMD -> .KwRead Var; OUTCMD -> .KwPrint Var; OUTCMD -> .KwPrint String; CONDITIONCMD -> .KwIf RELATIONALEXPRESSION KwThen COMMAND; CONDITIONCMD -> .KwIf RELATIONALEXPRESSION KwThen COMMAND KwElse COMMAND; REPEATCMD -> .KwWhile RELATIONALEXPRESSION COMMAND; SUBALGORITHM -> .KwBegin COMMANDLIST KwEnd}
goto(9, VARTYPE)	{STATEMENT -> Var Delim VARTYPE.}	11	{STATEMENT -> Var Delim VARTYPE.}
goto(9, KwInteger)	{VARTYPE -> KwInteger.}	12	{VARTYPE -> KwInteger.}
goto(9, KwReal)	{VARTYPE -> KwReal.}	13	{VARTYPE -> KwReal.}
goto(10, COMMANDLIST)	{PROGRAM -> Delim KwStatements STATEMENTLIST Delim KwAlgorithm COMMANDLIST.}	14	{PROGRAM -> Delim KwStatements STATEMENTLIST Delim KwAlgorithm COMMANDLIST.}
goto(10, COMMAND)	{COMMANDLIST -> COMMAND.COMMANDLIST; COMMANDLIST -> COMMAND.}	15	{COMMANDLIST -> COMMAND.COMMANDLIST; COMMANDLIST -> COMMAND.; COMMANDLIST -> .COMMAND COMMANDLIST; COMMANDLIST -> .COMMAND; COMMAND -> .ASSIGNCMD; COMMAND -> .INCMD; COMMAND -> .OUTCMD; COMMAND -> .CONDITIONCMD; COMMAND -> .REPEATCMD; COMMAND -> .SUBALGORITHM; ASSIGNCMD -> .KwAssign ARITHMETICEXPRESSION KwTo Var; INCMD -> .KwRead Var; OUTCMD -> .KwPrint Var; OUTCMD -> .KwPrint String; CONDITIONCMD -> .KwIf RELATIONALEXPRESSION KwThen COMMAND; CONDITIONCMD -> .KwIf RELATIONALEXPRESSION KwThen COMMAND KwElse COMMAND; REPEATCMD -> .KwWhile RELATIONALEXPRESSION COMMAND; SUBALGORITHM -> .KwBegin COMMANDLIST KwEnd}
goto(10, ASSIGNCMD)	{COMMAND -> ASSIGNCMD.}	16	{COMMAND -> ASSIGNCMD.}
goto(10, INCMD)	{COMMAND -> INCMD.}	17	{COMMAND -> INCMD.}
goto(10, OUTCMD)	{COMMAND -> OUTCMD.}	18	{COMMAND -> OUTCMD.}
goto(10, CONDITIONCMD)	{COMMAND -> CONDITIONCMD.}	19	{COMMAND -> CONDITIONCMD.}
goto(10, REPEATCMD)	{COMMAND -> REPEATCMD.}	20	{COMMAND -> REPEATCMD.}
goto(10, SUBALGORITHM)	{COMMAND -> SUBALGORITHM.}	21	{COMMAND -> SUBALGORITHM.}
goto(10, KwAssign)	{ASSIGNCMD -> KwAssign.ARITHMETICEXPRESSION KwTo Var}	22	{ASSIGNCMD -> KwAssign.ARITHMETICEXPRESSION KwTo Var; ARITHMETICEXPRESSION -> .ARITHMETICEXPRESSION OpAritSum ARITHMETICTERM; ARITHMETICEXPRESSION -> .ARITHMETICEXPRESSION OpAritSub ARITHMETICTERM; ARITHMETICEXPRESSION -> .ARITHMETICTERM; ARITHMETICTERM -> .ARITHMETICTERM OpAritMult ARITHMETICFACTOR; ARITHMETICTERM -> .ARITHMETICTERM OpAritDiv ARITHMETICFACTOR; ARITHMETICTERM -> .ARITHMETICFACTOR; ARITHMETICFACTOR -> .NumInt; ARITHMETICFACTOR -> .NumReal; ARITHMETICFACTOR -> .Var; ARITHMETICFACTOR -> .OpenPar ARITHMETICEXPRESSION ClosePar}
goto(10, KwRead)	{INCMD -> KwRead.Var}	23	{INCMD -> KwRead.Var}
goto(10, KwPrint)	{OUTCMD -> KwPrint.Var; OUTCMD -> KwPrint.String}	24	{OUTCMD -> KwPrint.Var; OUTCMD -> KwPrint.String}
goto(10, KwIf)	{CONDITIONCMD -> KwIf.RELATIONALEXPRESSION KwThen COMMAND; CONDITIONCMD -> KwIf.RELATIONALEXPRESSION KwThen COMMAND KwElse COMMAND}	25	{CONDITIONCMD -> KwIf.RELATIONALEXPRESSION KwThen COMMAND; CONDITIONCMD -> KwIf.RELATIONALEXPRESSION KwThen COMMAND KwElse COMMAND; RELATIONALEXPRESSION -> .RELATIONALEXPRESSION BOOLEANOPERATOR RELATIONALTERM; RELATIONALEXPRESSION -> .RELATIONALTERM; RELATIONALTERM -> .ARITHMETICEXPRESSION OpRel ARITHMETICEXPRESSION; RELATIONALTERM -> .OpenPar RELATIONALEXPRESSION ClosePar; ARITHMETICEXPRESSION -> .ARITHMETICEXPRESSION OpAritSum ARITHMETICTERM; ARITHMETICEXPRESSION -> .ARITHMETICEXPRESSION OpAritSub ARITHMETICTERM; ARITHMETICEXPRESSION -> .ARITHMETICTERM; ARITHMETICTERM -> .ARITHMETICTERM OpAritMult ARITHMETICFACTOR; ARITHMETICTERM -> .ARITHMETICTERM OpAritDiv ARITHMETICFACTOR; ARITHMETICTERM -> .ARITHMETICFACTOR; ARITHMETICFACTOR -> .NumInt; ARITHMETICFACTOR -> .NumReal; ARITHMETICFACTOR -> .Var; ARITHMETICFACTOR -> .OpenPar ARITHMETICEXPRESSION ClosePar}
goto(10, KwWhile)	{REPEATCMD -> KwWhile.RELATIONALEXPRESSION COMMAND}	26	{REPEATCMD -> KwWhile.RELATIONALEXPRESSION COMMAND; RELATIONALEXPRESSION -> .RELATIONALEXPRESSION BOOLEANOPERATOR RELATIONALTERM; RELATIONALEXPRESSION -> .RELATIONALTERM; RELATIONALTERM -> .ARITHMETICEXPRESSION OpRel ARITHMETICEXPRESSION; RELATIONALTERM -> .OpenPar RELATIONALEXPRESSION ClosePar; ARITHMETICEXPRESSION -> .ARITHMETICEXPRESSION OpAritSum ARITHMETICTERM; ARITHMETICEXPRESSION -> .ARITHMETICEXPRESSION OpAritSub ARITHMETICTERM; ARITHMETICEXPRESSION -> .ARITHMETICTERM; ARITHMETICTERM -> .ARITHMETICTERM OpAritMult ARITHMETICFACTOR; ARITHMETICTERM -> .ARITHMETICTERM OpAritDiv ARITHMETICFACTOR; ARITHMETICTERM -> .ARITHMETICFACTOR; ARITHMETICFACTOR -> .NumInt; ARITHMETICFACTOR -> .NumReal; ARITHMETICFACTOR -> .Var; ARITHMETICFACTOR -> .OpenPar ARITHMETICEXPRESSION ClosePar}
goto(10, KwBegin)	{SUBALGORITHM -> KwBegin.COMMANDLIST KwEnd}	27	{SUBALGORITHM -> KwBegin.COMMANDLIST KwEnd; COMMANDLIST -> .COMMAND COMMANDLIST; COMMANDLIST -> .COMMAND; COMMAND -> .ASSIGNCMD; COMMAND -> .INCMD; COMMAND -> .OUTCMD; COMMAND -> .CONDITIONCMD; COMMAND -> .REPEATCMD; COMMAND -> .SUBALGORITHM; ASSIGNCMD -> .KwAssign ARITHMETICEXPRESSION KwTo Var; INCMD -> .KwRead Var; OUTCMD -> .KwPrint Var; OUTCMD -> .KwPrint String; CONDITIONCMD -> .KwIf RELATIONALEXPRESSION KwThen COMMAND; CONDITIONCMD -> .KwIf RELATIONALEXPRESSION KwThen COMMAND KwElse COMMAND; REPEATCMD -> .KwWhile RELATIONALEXPRESSION COMMAND; SUBALGORITHM -> .KwBegin COMMANDLIST KwEnd}
goto(15, COMMANDLIST)	{COMMANDLIST -> COMMAND COMMANDLIST.}	28	{COMMANDLIST -> COMMAND COMMANDLIST.}
goto(15, COMMAND)	{COMMANDLIST -> COMMAND.COMMANDLIST; COMMANDLIST -> COMMAND.}	15	 
goto(15, ASSIGNCMD)	{COMMAND -> ASSIGNCMD.}	16	 
goto(15, INCMD)	{COMMAND -> INCMD.}	17	 
goto(15, OUTCMD)	{COMMAND -> OUTCMD.}	18	 
goto(15, CONDITIONCMD)	{COMMAND -> CONDITIONCMD.}	19	 
goto(15, REPEATCMD)	{COMMAND -> REPEATCMD.}	20	 
goto(15, SUBALGORITHM)	{COMMAND -> SUBALGORITHM.}	21	 
goto(15, KwAssign)	{ASSIGNCMD -> KwAssign.ARITHMETICEXPRESSION KwTo Var}	22	 
goto(15, KwRead)	{INCMD -> KwRead.Var}	23	 
goto(15, KwPrint)	{OUTCMD -> KwPrint.Var; OUTCMD -> KwPrint.String}	24	 
goto(15, KwIf)	{CONDITIONCMD -> KwIf.RELATIONALEXPRESSION KwThen COMMAND; CONDITIONCMD -> KwIf.RELATIONALEXPRESSION KwThen COMMAND KwElse COMMAND}	25	 
goto(15, KwWhile)	{REPEATCMD -> KwWhile.RELATIONALEXPRESSION COMMAND}	26	 
goto(15, KwBegin)	{SUBALGORITHM -> KwBegin.COMMANDLIST KwEnd}	27	 
goto(22, ARITHMETICEXPRESSION)	{ASSIGNCMD -> KwAssign ARITHMETICEXPRESSION.KwTo Var; ARITHMETICEXPRESSION -> ARITHMETICEXPRESSION.OpAritSum ARITHMETICTERM; ARITHMETICEXPRESSION -> ARITHMETICEXPRESSION.OpAritSub ARITHMETICTERM}	29	{ASSIGNCMD -> KwAssign ARITHMETICEXPRESSION.KwTo Var; ARITHMETICEXPRESSION -> ARITHMETICEXPRESSION.OpAritSum ARITHMETICTERM; ARITHMETICEXPRESSION -> ARITHMETICEXPRESSION.OpAritSub ARITHMETICTERM}
goto(22, ARITHMETICTERM)	{ARITHMETICEXPRESSION -> ARITHMETICTERM.; ARITHMETICTERM -> ARITHMETICTERM.OpAritMult ARITHMETICFACTOR; ARITHMETICTERM -> ARITHMETICTERM.OpAritDiv ARITHMETICFACTOR}	30	{ARITHMETICEXPRESSION -> ARITHMETICTERM.; ARITHMETICTERM -> ARITHMETICTERM.OpAritMult ARITHMETICFACTOR; ARITHMETICTERM -> ARITHMETICTERM.OpAritDiv ARITHMETICFACTOR}
goto(22, ARITHMETICFACTOR)	{ARITHMETICTERM -> ARITHMETICFACTOR.}	31	{ARITHMETICTERM -> ARITHMETICFACTOR.}
goto(22, NumInt)	{ARITHMETICFACTOR -> NumInt.}	32	{ARITHMETICFACTOR -> NumInt.}
goto(22, NumReal)	{ARITHMETICFACTOR -> NumReal.}	33	{ARITHMETICFACTOR -> NumReal.}
goto(22, Var)	{ARITHMETICFACTOR -> Var.}	34	{ARITHMETICFACTOR -> Var.}
goto(22, OpenPar)	{ARITHMETICFACTOR -> OpenPar.ARITHMETICEXPRESSION ClosePar}	35	{ARITHMETICFACTOR -> OpenPar.ARITHMETICEXPRESSION ClosePar; ARITHMETICEXPRESSION -> .ARITHMETICEXPRESSION OpAritSum ARITHMETICTERM; ARITHMETICEXPRESSION -> .ARITHMETICEXPRESSION OpAritSub ARITHMETICTERM; ARITHMETICEXPRESSION -> .ARITHMETICTERM; ARITHMETICTERM -> .ARITHMETICTERM OpAritMult ARITHMETICFACTOR; ARITHMETICTERM -> .ARITHMETICTERM OpAritDiv ARITHMETICFACTOR; ARITHMETICTERM -> .ARITHMETICFACTOR; ARITHMETICFACTOR -> .NumInt; ARITHMETICFACTOR -> .NumReal; ARITHMETICFACTOR -> .Var; ARITHMETICFACTOR -> .OpenPar ARITHMETICEXPRESSION ClosePar}
goto(23, Var)	{INCMD -> KwRead Var.}	36	{INCMD -> KwRead Var.}
goto(24, Var)	{OUTCMD -> KwPrint Var.}	37	{OUTCMD -> KwPrint Var.}
goto(24, String)	{OUTCMD -> KwPrint String.}	38	{OUTCMD -> KwPrint String.}
goto(25, RELATIONALEXPRESSION)	{CONDITIONCMD -> KwIf RELATIONALEXPRESSION.KwThen COMMAND; CONDITIONCMD -> KwIf RELATIONALEXPRESSION.KwThen COMMAND KwElse COMMAND; RELATIONALEXPRESSION -> RELATIONALEXPRESSION.BOOLEANOPERATOR RELATIONALTERM}	39	{CONDITIONCMD -> KwIf RELATIONALEXPRESSION.KwThen COMMAND; CONDITIONCMD -> KwIf RELATIONALEXPRESSION.KwThen COMMAND KwElse COMMAND; RELATIONALEXPRESSION -> RELATIONALEXPRESSION.BOOLEANOPERATOR RELATIONALTERM; BOOLEANOPERATOR -> .OpBoolAnd; BOOLEANOPERATOR -> .OpBoolOr}
goto(25, RELATIONALTERM)	{RELATIONALEXPRESSION -> RELATIONALTERM.}	40	{RELATIONALEXPRESSION -> RELATIONALTERM.}
goto(25, ARITHMETICEXPRESSION)	{RELATIONALTERM -> ARITHMETICEXPRESSION.OpRel ARITHMETICEXPRESSION; ARITHMETICEXPRESSION -> ARITHMETICEXPRESSION.OpAritSum ARITHMETICTERM; ARITHMETICEXPRESSION -> ARITHMETICEXPRESSION.OpAritSub ARITHMETICTERM}	41	{RELATIONALTERM -> ARITHMETICEXPRESSION.OpRel ARITHMETICEXPRESSION; ARITHMETICEXPRESSION -> ARITHMETICEXPRESSION.OpAritSum ARITHMETICTERM; ARITHMETICEXPRESSION -> ARITHMETICEXPRESSION.OpAritSub ARITHMETICTERM}
goto(25, OpenPar)	{RELATIONALTERM -> OpenPar.RELATIONALEXPRESSION ClosePar; ARITHMETICFACTOR -> OpenPar.ARITHMETICEXPRESSION ClosePar}	42	{RELATIONALTERM -> OpenPar.RELATIONALEXPRESSION ClosePar; ARITHMETICFACTOR -> OpenPar.ARITHMETICEXPRESSION ClosePar; RELATIONALEXPRESSION -> .RELATIONALEXPRESSION BOOLEANOPERATOR RELATIONALTERM; RELATIONALEXPRESSION -> .RELATIONALTERM; ARITHMETICEXPRESSION -> .ARITHMETICEXPRESSION OpAritSum ARITHMETICTERM; ARITHMETICEXPRESSION -> .ARITHMETICEXPRESSION OpAritSub ARITHMETICTERM; ARITHMETICEXPRESSION -> .ARITHMETICTERM; RELATIONALTERM -> .ARITHMETICEXPRESSION OpRel ARITHMETICEXPRESSION; RELATIONALTERM -> .OpenPar RELATIONALEXPRESSION ClosePar; ARITHMETICTERM -> .ARITHMETICTERM OpAritMult ARITHMETICFACTOR; ARITHMETICTERM -> .ARITHMETICTERM OpAritDiv ARITHMETICFACTOR; ARITHMETICTERM -> .ARITHMETICFACTOR; ARITHMETICFACTOR -> .NumInt; ARITHMETICFACTOR -> .NumReal; ARITHMETICFACTOR -> .Var; ARITHMETICFACTOR -> .OpenPar ARITHMETICEXPRESSION ClosePar}
goto(25, ARITHMETICTERM)	{ARITHMETICEXPRESSION -> ARITHMETICTERM.; ARITHMETICTERM -> ARITHMETICTERM.OpAritMult ARITHMETICFACTOR; ARITHMETICTERM -> ARITHMETICTERM.OpAritDiv ARITHMETICFACTOR}	30	 
goto(25, ARITHMETICFACTOR)	{ARITHMETICTERM -> ARITHMETICFACTOR.}	31	 
goto(25, NumInt)	{ARITHMETICFACTOR -> NumInt.}	32	 
goto(25, NumReal)	{ARITHMETICFACTOR -> NumReal.}	33	 
goto(25, Var)	{ARITHMETICFACTOR -> Var.}	34	 
goto(26, RELATIONALEXPRESSION)	{REPEATCMD -> KwWhile RELATIONALEXPRESSION.COMMAND; RELATIONALEXPRESSION -> RELATIONALEXPRESSION.BOOLEANOPERATOR RELATIONALTERM}	43	{REPEATCMD -> KwWhile RELATIONALEXPRESSION.COMMAND; RELATIONALEXPRESSION -> RELATIONALEXPRESSION.BOOLEANOPERATOR RELATIONALTERM; COMMAND -> .ASSIGNCMD; COMMAND -> .INCMD; COMMAND -> .OUTCMD; COMMAND -> .CONDITIONCMD; COMMAND -> .REPEATCMD; COMMAND -> .SUBALGORITHM; BOOLEANOPERATOR -> .OpBoolAnd; BOOLEANOPERATOR -> .OpBoolOr; ASSIGNCMD -> .KwAssign ARITHMETICEXPRESSION KwTo Var; INCMD -> .KwRead Var; OUTCMD -> .KwPrint Var; OUTCMD -> .KwPrint String; CONDITIONCMD -> .KwIf RELATIONALEXPRESSION KwThen COMMAND; CONDITIONCMD -> .KwIf RELATIONALEXPRESSION KwThen COMMAND KwElse COMMAND; REPEATCMD -> .KwWhile RELATIONALEXPRESSION COMMAND; SUBALGORITHM -> .KwBegin COMMANDLIST KwEnd}
goto(26, RELATIONALTERM)	{RELATIONALEXPRESSION -> RELATIONALTERM.}	40	 
goto(26, ARITHMETICEXPRESSION)	{RELATIONALTERM -> ARITHMETICEXPRESSION.OpRel ARITHMETICEXPRESSION; ARITHMETICEXPRESSION -> ARITHMETICEXPRESSION.OpAritSum ARITHMETICTERM; ARITHMETICEXPRESSION -> ARITHMETICEXPRESSION.OpAritSub ARITHMETICTERM}	41	 
goto(26, OpenPar)	{RELATIONALTERM -> OpenPar.RELATIONALEXPRESSION ClosePar; ARITHMETICFACTOR -> OpenPar.ARITHMETICEXPRESSION ClosePar}	42	 
goto(26, ARITHMETICTERM)	{ARITHMETICEXPRESSION -> ARITHMETICTERM.; ARITHMETICTERM -> ARITHMETICTERM.OpAritMult ARITHMETICFACTOR; ARITHMETICTERM -> ARITHMETICTERM.OpAritDiv ARITHMETICFACTOR}	30	 
goto(26, ARITHMETICFACTOR)	{ARITHMETICTERM -> ARITHMETICFACTOR.}	31	 
goto(26, NumInt)	{ARITHMETICFACTOR -> NumInt.}	32	 
goto(26, NumReal)	{ARITHMETICFACTOR -> NumReal.}	33	 
goto(26, Var)	{ARITHMETICFACTOR -> Var.}	34	 
goto(27, COMMANDLIST)	{SUBALGORITHM -> KwBegin COMMANDLIST.KwEnd}	44	{SUBALGORITHM -> KwBegin COMMANDLIST.KwEnd}
goto(27, COMMAND)	{COMMANDLIST -> COMMAND.COMMANDLIST; COMMANDLIST -> COMMAND.}	15	 
goto(27, ASSIGNCMD)	{COMMAND -> ASSIGNCMD.}	16	 
goto(27, INCMD)	{COMMAND -> INCMD.}	17	 
goto(27, OUTCMD)	{COMMAND -> OUTCMD.}	18	 
goto(27, CONDITIONCMD)	{COMMAND -> CONDITIONCMD.}	19	 
goto(27, REPEATCMD)	{COMMAND -> REPEATCMD.}	20	 
goto(27, SUBALGORITHM)	{COMMAND -> SUBALGORITHM.}	21	 
goto(27, KwAssign)	{ASSIGNCMD -> KwAssign.ARITHMETICEXPRESSION KwTo Var}	22	 
goto(27, KwRead)	{INCMD -> KwRead.Var}	23	 
goto(27, KwPrint)	{OUTCMD -> KwPrint.Var; OUTCMD -> KwPrint.String}	24	 
goto(27, KwIf)	{CONDITIONCMD -> KwIf.RELATIONALEXPRESSION KwThen COMMAND; CONDITIONCMD -> KwIf.RELATIONALEXPRESSION KwThen COMMAND KwElse COMMAND}	25	 
goto(27, KwWhile)	{REPEATCMD -> KwWhile.RELATIONALEXPRESSION COMMAND}	26	 
goto(27, KwBegin)	{SUBALGORITHM -> KwBegin.COMMANDLIST KwEnd}	27	 
goto(29, KwTo)	{ASSIGNCMD -> KwAssign ARITHMETICEXPRESSION KwTo.Var}	45	{ASSIGNCMD -> KwAssign ARITHMETICEXPRESSION KwTo.Var}
goto(29, OpAritSum)	{ARITHMETICEXPRESSION -> ARITHMETICEXPRESSION OpAritSum.ARITHMETICTERM}	46	{ARITHMETICEXPRESSION -> ARITHMETICEXPRESSION OpAritSum.ARITHMETICTERM; ARITHMETICTERM -> .ARITHMETICTERM OpAritMult ARITHMETICFACTOR; ARITHMETICTERM -> .ARITHMETICTERM OpAritDiv ARITHMETICFACTOR; ARITHMETICTERM -> .ARITHMETICFACTOR; ARITHMETICFACTOR -> .NumInt; ARITHMETICFACTOR -> .NumReal; ARITHMETICFACTOR -> .Var; ARITHMETICFACTOR -> .OpenPar ARITHMETICEXPRESSION ClosePar}
goto(29, OpAritSub)	{ARITHMETICEXPRESSION -> ARITHMETICEXPRESSION OpAritSub.ARITHMETICTERM}	47	{ARITHMETICEXPRESSION -> ARITHMETICEXPRESSION OpAritSub.ARITHMETICTERM; ARITHMETICTERM -> .ARITHMETICTERM OpAritMult ARITHMETICFACTOR; ARITHMETICTERM -> .ARITHMETICTERM OpAritDiv ARITHMETICFACTOR; ARITHMETICTERM -> .ARITHMETICFACTOR; ARITHMETICFACTOR -> .NumInt; ARITHMETICFACTOR -> .NumReal; ARITHMETICFACTOR -> .Var; ARITHMETICFACTOR -> .OpenPar ARITHMETICEXPRESSION ClosePar}
goto(30, OpAritMult)	{ARITHMETICTERM -> ARITHMETICTERM OpAritMult.ARITHMETICFACTOR}	48	{ARITHMETICTERM -> ARITHMETICTERM OpAritMult.ARITHMETICFACTOR; ARITHMETICFACTOR -> .NumInt; ARITHMETICFACTOR -> .NumReal; ARITHMETICFACTOR -> .Var; ARITHMETICFACTOR -> .OpenPar ARITHMETICEXPRESSION ClosePar}
goto(30, OpAritDiv)	{ARITHMETICTERM -> ARITHMETICTERM OpAritDiv.ARITHMETICFACTOR}	49	{ARITHMETICTERM -> ARITHMETICTERM OpAritDiv.ARITHMETICFACTOR; ARITHMETICFACTOR -> .NumInt; ARITHMETICFACTOR -> .NumReal; ARITHMETICFACTOR -> .Var; ARITHMETICFACTOR -> .OpenPar ARITHMETICEXPRESSION ClosePar}
goto(35, ARITHMETICEXPRESSION)	{ARITHMETICFACTOR -> OpenPar ARITHMETICEXPRESSION.ClosePar; ARITHMETICEXPRESSION -> ARITHMETICEXPRESSION.OpAritSum ARITHMETICTERM; ARITHMETICEXPRESSION -> ARITHMETICEXPRESSION.OpAritSub ARITHMETICTERM}	50	{ARITHMETICFACTOR -> OpenPar ARITHMETICEXPRESSION.ClosePar; ARITHMETICEXPRESSION -> ARITHMETICEXPRESSION.OpAritSum ARITHMETICTERM; ARITHMETICEXPRESSION -> ARITHMETICEXPRESSION.OpAritSub ARITHMETICTERM}
goto(35, ARITHMETICTERM)	{ARITHMETICEXPRESSION -> ARITHMETICTERM.; ARITHMETICTERM -> ARITHMETICTERM.OpAritMult ARITHMETICFACTOR; ARITHMETICTERM -> ARITHMETICTERM.OpAritDiv ARITHMETICFACTOR}	30	 
goto(35, ARITHMETICFACTOR)	{ARITHMETICTERM -> ARITHMETICFACTOR.}	31	 
goto(35, NumInt)	{ARITHMETICFACTOR -> NumInt.}	32	 
goto(35, NumReal)	{ARITHMETICFACTOR -> NumReal.}	33	 
goto(35, Var)	{ARITHMETICFACTOR -> Var.}	34	 
goto(35, OpenPar)	{ARITHMETICFACTOR -> OpenPar.ARITHMETICEXPRESSION ClosePar}	35	 
goto(39, KwThen)	{CONDITIONCMD -> KwIf RELATIONALEXPRESSION KwThen.COMMAND; CONDITIONCMD -> KwIf RELATIONALEXPRESSION KwThen.COMMAND KwElse COMMAND}	51	{CONDITIONCMD -> KwIf RELATIONALEXPRESSION KwThen.COMMAND; CONDITIONCMD -> KwIf RELATIONALEXPRESSION KwThen.COMMAND KwElse COMMAND; COMMAND -> .ASSIGNCMD; COMMAND -> .INCMD; COMMAND -> .OUTCMD; COMMAND -> .CONDITIONCMD; COMMAND -> .REPEATCMD; COMMAND -> .SUBALGORITHM; ASSIGNCMD -> .KwAssign ARITHMETICEXPRESSION KwTo Var; INCMD -> .KwRead Var; OUTCMD -> .KwPrint Var; OUTCMD -> .KwPrint String; CONDITIONCMD -> .KwIf RELATIONALEXPRESSION KwThen COMMAND; CONDITIONCMD -> .KwIf RELATIONALEXPRESSION KwThen COMMAND KwElse COMMAND; REPEATCMD -> .KwWhile RELATIONALEXPRESSION COMMAND; SUBALGORITHM -> .KwBegin COMMANDLIST KwEnd}
goto(39, BOOLEANOPERATOR)	{RELATIONALEXPRESSION -> RELATIONALEXPRESSION BOOLEANOPERATOR.RELATIONALTERM}	52	{RELATIONALEXPRESSION -> RELATIONALEXPRESSION BOOLEANOPERATOR.RELATIONALTERM; RELATIONALTERM -> .ARITHMETICEXPRESSION OpRel ARITHMETICEXPRESSION; RELATIONALTERM -> .OpenPar RELATIONALEXPRESSION ClosePar; ARITHMETICEXPRESSION -> .ARITHMETICEXPRESSION OpAritSum ARITHMETICTERM; ARITHMETICEXPRESSION -> .ARITHMETICEXPRESSION OpAritSub ARITHMETICTERM; ARITHMETICEXPRESSION -> .ARITHMETICTERM; ARITHMETICTERM -> .ARITHMETICTERM OpAritMult ARITHMETICFACTOR; ARITHMETICTERM -> .ARITHMETICTERM OpAritDiv ARITHMETICFACTOR; ARITHMETICTERM -> .ARITHMETICFACTOR; ARITHMETICFACTOR -> .NumInt; ARITHMETICFACTOR -> .NumReal; ARITHMETICFACTOR -> .Var; ARITHMETICFACTOR -> .OpenPar ARITHMETICEXPRESSION ClosePar}
goto(39, OpBoolAnd)	{BOOLEANOPERATOR -> OpBoolAnd.}	53	{BOOLEANOPERATOR -> OpBoolAnd.}
goto(39, OpBoolOr)	{BOOLEANOPERATOR -> OpBoolOr.}	54	{BOOLEANOPERATOR -> OpBoolOr.}
goto(41, OpRel)	{RELATIONALTERM -> ARITHMETICEXPRESSION OpRel.ARITHMETICEXPRESSION}	55	{RELATIONALTERM -> ARITHMETICEXPRESSION OpRel.ARITHMETICEXPRESSION; ARITHMETICEXPRESSION -> .ARITHMETICEXPRESSION OpAritSum ARITHMETICTERM; ARITHMETICEXPRESSION -> .ARITHMETICEXPRESSION OpAritSub ARITHMETICTERM; ARITHMETICEXPRESSION -> .ARITHMETICTERM; ARITHMETICTERM -> .ARITHMETICTERM OpAritMult ARITHMETICFACTOR; ARITHMETICTERM -> .ARITHMETICTERM OpAritDiv ARITHMETICFACTOR; ARITHMETICTERM -> .ARITHMETICFACTOR; ARITHMETICFACTOR -> .NumInt; ARITHMETICFACTOR -> .NumReal; ARITHMETICFACTOR -> .Var; ARITHMETICFACTOR -> .OpenPar ARITHMETICEXPRESSION ClosePar}
goto(41, OpAritSum)	{ARITHMETICEXPRESSION -> ARITHMETICEXPRESSION OpAritSum.ARITHMETICTERM}	46	 
goto(41, OpAritSub)	{ARITHMETICEXPRESSION -> ARITHMETICEXPRESSION OpAritSub.ARITHMETICTERM}	47	 
goto(42, RELATIONALEXPRESSION)	{RELATIONALTERM -> OpenPar RELATIONALEXPRESSION.ClosePar; RELATIONALEXPRESSION -> RELATIONALEXPRESSION.BOOLEANOPERATOR RELATIONALTERM}	56	{RELATIONALTERM -> OpenPar RELATIONALEXPRESSION.ClosePar; RELATIONALEXPRESSION -> RELATIONALEXPRESSION.BOOLEANOPERATOR RELATIONALTERM; BOOLEANOPERATOR -> .OpBoolAnd; BOOLEANOPERATOR -> .OpBoolOr}
goto(42, ARITHMETICEXPRESSION)	{ARITHMETICFACTOR -> OpenPar ARITHMETICEXPRESSION.ClosePar; ARITHMETICEXPRESSION -> ARITHMETICEXPRESSION.OpAritSum ARITHMETICTERM; ARITHMETICEXPRESSION -> ARITHMETICEXPRESSION.OpAritSub ARITHMETICTERM; RELATIONALTERM -> ARITHMETICEXPRESSION.OpRel ARITHMETICEXPRESSION}	57	{ARITHMETICFACTOR -> OpenPar ARITHMETICEXPRESSION.ClosePar; ARITHMETICEXPRESSION -> ARITHMETICEXPRESSION.OpAritSum ARITHMETICTERM; ARITHMETICEXPRESSION -> ARITHMETICEXPRESSION.OpAritSub ARITHMETICTERM; RELATIONALTERM -> ARITHMETICEXPRESSION.OpRel ARITHMETICEXPRESSION}
goto(42, RELATIONALTERM)	{RELATIONALEXPRESSION -> RELATIONALTERM.}	40	 
goto(42, ARITHMETICTERM)	{ARITHMETICEXPRESSION -> ARITHMETICTERM.; ARITHMETICTERM -> ARITHMETICTERM.OpAritMult ARITHMETICFACTOR; ARITHMETICTERM -> ARITHMETICTERM.OpAritDiv ARITHMETICFACTOR}	30	 
goto(42, OpenPar)	{RELATIONALTERM -> OpenPar.RELATIONALEXPRESSION ClosePar; ARITHMETICFACTOR -> OpenPar.ARITHMETICEXPRESSION ClosePar}	42	 
goto(42, ARITHMETICFACTOR)	{ARITHMETICTERM -> ARITHMETICFACTOR.}	31	 
goto(42, NumInt)	{ARITHMETICFACTOR -> NumInt.}	32	 
goto(42, NumReal)	{ARITHMETICFACTOR -> NumReal.}	33	 
goto(42, Var)	{ARITHMETICFACTOR -> Var.}	34	 
goto(43, COMMAND)	{REPEATCMD -> KwWhile RELATIONALEXPRESSION COMMAND.}	58	{REPEATCMD -> KwWhile RELATIONALEXPRESSION COMMAND.}
goto(43, BOOLEANOPERATOR)	{RELATIONALEXPRESSION -> RELATIONALEXPRESSION BOOLEANOPERATOR.RELATIONALTERM}	52	 
goto(43, ASSIGNCMD)	{COMMAND -> ASSIGNCMD.}	16	 
goto(43, INCMD)	{COMMAND -> INCMD.}	17	 
goto(43, OUTCMD)	{COMMAND -> OUTCMD.}	18	 
goto(43, CONDITIONCMD)	{COMMAND -> CONDITIONCMD.}	19	 
goto(43, REPEATCMD)	{COMMAND -> REPEATCMD.}	20	 
goto(43, SUBALGORITHM)	{COMMAND -> SUBALGORITHM.}	21	 
goto(43, OpBoolAnd)	{BOOLEANOPERATOR -> OpBoolAnd.}	53	 
goto(43, OpBoolOr)	{BOOLEANOPERATOR -> OpBoolOr.}	54	 
goto(43, KwAssign)	{ASSIGNCMD -> KwAssign.ARITHMETICEXPRESSION KwTo Var}	22	 
goto(43, KwRead)	{INCMD -> KwRead.Var}	23	 
goto(43, KwPrint)	{OUTCMD -> KwPrint.Var; OUTCMD -> KwPrint.String}	24	 
goto(43, KwIf)	{CONDITIONCMD -> KwIf.RELATIONALEXPRESSION KwThen COMMAND; CONDITIONCMD -> KwIf.RELATIONALEXPRESSION KwThen COMMAND KwElse COMMAND}	25	 
goto(43, KwWhile)	{REPEATCMD -> KwWhile.RELATIONALEXPRESSION COMMAND}	26	 
goto(43, KwBegin)	{SUBALGORITHM -> KwBegin.COMMANDLIST KwEnd}	27	 
goto(44, KwEnd)	{SUBALGORITHM -> KwBegin COMMANDLIST KwEnd.}	59	{SUBALGORITHM -> KwBegin COMMANDLIST KwEnd.}
goto(45, Var)	{ASSIGNCMD -> KwAssign ARITHMETICEXPRESSION KwTo Var.}	60	{ASSIGNCMD -> KwAssign ARITHMETICEXPRESSION KwTo Var.}
goto(46, ARITHMETICTERM)	{ARITHMETICEXPRESSION -> ARITHMETICEXPRESSION OpAritSum ARITHMETICTERM.; ARITHMETICTERM -> ARITHMETICTERM.OpAritMult ARITHMETICFACTOR; ARITHMETICTERM -> ARITHMETICTERM.OpAritDiv ARITHMETICFACTOR}	61	{ARITHMETICEXPRESSION -> ARITHMETICEXPRESSION OpAritSum ARITHMETICTERM.; ARITHMETICTERM -> ARITHMETICTERM.OpAritMult ARITHMETICFACTOR; ARITHMETICTERM -> ARITHMETICTERM.OpAritDiv ARITHMETICFACTOR}
goto(46, ARITHMETICFACTOR)	{ARITHMETICTERM -> ARITHMETICFACTOR.}	31	 
goto(46, NumInt)	{ARITHMETICFACTOR -> NumInt.}	32	 
goto(46, NumReal)	{ARITHMETICFACTOR -> NumReal.}	33	 
goto(46, Var)	{ARITHMETICFACTOR -> Var.}	34	 
goto(46, OpenPar)	{ARITHMETICFACTOR -> OpenPar.ARITHMETICEXPRESSION ClosePar}	35	 
goto(47, ARITHMETICTERM)	{ARITHMETICEXPRESSION -> ARITHMETICEXPRESSION OpAritSub ARITHMETICTERM.; ARITHMETICTERM -> ARITHMETICTERM.OpAritMult ARITHMETICFACTOR; ARITHMETICTERM -> ARITHMETICTERM.OpAritDiv ARITHMETICFACTOR}	62	{ARITHMETICEXPRESSION -> ARITHMETICEXPRESSION OpAritSub ARITHMETICTERM.; ARITHMETICTERM -> ARITHMETICTERM.OpAritMult ARITHMETICFACTOR; ARITHMETICTERM -> ARITHMETICTERM.OpAritDiv ARITHMETICFACTOR}
goto(47, ARITHMETICFACTOR)	{ARITHMETICTERM -> ARITHMETICFACTOR.}	31	 
goto(47, NumInt)	{ARITHMETICFACTOR -> NumInt.}	32	 
goto(47, NumReal)	{ARITHMETICFACTOR -> NumReal.}	33	 
goto(47, Var)	{ARITHMETICFACTOR -> Var.}	34	 
goto(47, OpenPar)	{ARITHMETICFACTOR -> OpenPar.ARITHMETICEXPRESSION ClosePar}	35	 
goto(48, ARITHMETICFACTOR)	{ARITHMETICTERM -> ARITHMETICTERM OpAritMult ARITHMETICFACTOR.}	63	{ARITHMETICTERM -> ARITHMETICTERM OpAritMult ARITHMETICFACTOR.}
goto(48, NumInt)	{ARITHMETICFACTOR -> NumInt.}	32	 
goto(48, NumReal)	{ARITHMETICFACTOR -> NumReal.}	33	 
goto(48, Var)	{ARITHMETICFACTOR -> Var.}	34	 
goto(48, OpenPar)	{ARITHMETICFACTOR -> OpenPar.ARITHMETICEXPRESSION ClosePar}	35	 
goto(49, ARITHMETICFACTOR)	{ARITHMETICTERM -> ARITHMETICTERM OpAritDiv ARITHMETICFACTOR.}	64	{ARITHMETICTERM -> ARITHMETICTERM OpAritDiv ARITHMETICFACTOR.}
goto(49, NumInt)	{ARITHMETICFACTOR -> NumInt.}	32	 
goto(49, NumReal)	{ARITHMETICFACTOR -> NumReal.}	33	 
goto(49, Var)	{ARITHMETICFACTOR -> Var.}	34	 
goto(49, OpenPar)	{ARITHMETICFACTOR -> OpenPar.ARITHMETICEXPRESSION ClosePar}	35	 
goto(50, ClosePar)	{ARITHMETICFACTOR -> OpenPar ARITHMETICEXPRESSION ClosePar.}	65	{ARITHMETICFACTOR -> OpenPar ARITHMETICEXPRESSION ClosePar.}
goto(50, OpAritSum)	{ARITHMETICEXPRESSION -> ARITHMETICEXPRESSION OpAritSum.ARITHMETICTERM}	46	 
goto(50, OpAritSub)	{ARITHMETICEXPRESSION -> ARITHMETICEXPRESSION OpAritSub.ARITHMETICTERM}	47	 
goto(51, COMMAND)	{CONDITIONCMD -> KwIf RELATIONALEXPRESSION KwThen COMMAND.; CONDITIONCMD -> KwIf RELATIONALEXPRESSION KwThen COMMAND.KwElse COMMAND}	66	{CONDITIONCMD -> KwIf RELATIONALEXPRESSION KwThen COMMAND.; CONDITIONCMD -> KwIf RELATIONALEXPRESSION KwThen COMMAND.KwElse COMMAND}
goto(51, ASSIGNCMD)	{COMMAND -> ASSIGNCMD.}	16	 
goto(51, INCMD)	{COMMAND -> INCMD.}	17	 
goto(51, OUTCMD)	{COMMAND -> OUTCMD.}	18	 
goto(51, CONDITIONCMD)	{COMMAND -> CONDITIONCMD.}	19	 
goto(51, REPEATCMD)	{COMMAND -> REPEATCMD.}	20	 
goto(51, SUBALGORITHM)	{COMMAND -> SUBALGORITHM.}	21	 
goto(51, KwAssign)	{ASSIGNCMD -> KwAssign.ARITHMETICEXPRESSION KwTo Var}	22	 
goto(51, KwRead)	{INCMD -> KwRead.Var}	23	 
goto(51, KwPrint)	{OUTCMD -> KwPrint.Var; OUTCMD -> KwPrint.String}	24	 
goto(51, KwIf)	{CONDITIONCMD -> KwIf.RELATIONALEXPRESSION KwThen COMMAND; CONDITIONCMD -> KwIf.RELATIONALEXPRESSION KwThen COMMAND KwElse COMMAND}	25	 
goto(51, KwWhile)	{REPEATCMD -> KwWhile.RELATIONALEXPRESSION COMMAND}	26	 
goto(51, KwBegin)	{SUBALGORITHM -> KwBegin.COMMANDLIST KwEnd}	27	 
goto(52, RELATIONALTERM)	{RELATIONALEXPRESSION -> RELATIONALEXPRESSION BOOLEANOPERATOR RELATIONALTERM.}	67	{RELATIONALEXPRESSION -> RELATIONALEXPRESSION BOOLEANOPERATOR RELATIONALTERM.}
goto(52, ARITHMETICEXPRESSION)	{RELATIONALTERM -> ARITHMETICEXPRESSION.OpRel ARITHMETICEXPRESSION; ARITHMETICEXPRESSION -> ARITHMETICEXPRESSION.OpAritSum ARITHMETICTERM; ARITHMETICEXPRESSION -> ARITHMETICEXPRESSION.OpAritSub ARITHMETICTERM}	41	 
goto(52, OpenPar)	{RELATIONALTERM -> OpenPar.RELATIONALEXPRESSION ClosePar; ARITHMETICFACTOR -> OpenPar.ARITHMETICEXPRESSION ClosePar}	42	 
goto(52, ARITHMETICTERM)	{ARITHMETICEXPRESSION -> ARITHMETICTERM.; ARITHMETICTERM -> ARITHMETICTERM.OpAritMult ARITHMETICFACTOR; ARITHMETICTERM -> ARITHMETICTERM.OpAritDiv ARITHMETICFACTOR}	30	 
goto(52, ARITHMETICFACTOR)	{ARITHMETICTERM -> ARITHMETICFACTOR.}	31	 
goto(52, NumInt)	{ARITHMETICFACTOR -> NumInt.}	32	 
goto(52, NumReal)	{ARITHMETICFACTOR -> NumReal.}	33	 
goto(52, Var)	{ARITHMETICFACTOR -> Var.}	34	 
goto(55, ARITHMETICEXPRESSION)	{RELATIONALTERM -> ARITHMETICEXPRESSION OpRel ARITHMETICEXPRESSION.; ARITHMETICEXPRESSION -> ARITHMETICEXPRESSION.OpAritSum ARITHMETICTERM; ARITHMETICEXPRESSION -> ARITHMETICEXPRESSION.OpAritSub ARITHMETICTERM}	68	{RELATIONALTERM -> ARITHMETICEXPRESSION OpRel ARITHMETICEXPRESSION.; ARITHMETICEXPRESSION -> ARITHMETICEXPRESSION.OpAritSum ARITHMETICTERM; ARITHMETICEXPRESSION -> ARITHMETICEXPRESSION.OpAritSub ARITHMETICTERM}
goto(55, ARITHMETICTERM)	{ARITHMETICEXPRESSION -> ARITHMETICTERM.; ARITHMETICTERM -> ARITHMETICTERM.OpAritMult ARITHMETICFACTOR; ARITHMETICTERM -> ARITHMETICTERM.OpAritDiv ARITHMETICFACTOR}	30	 
goto(55, ARITHMETICFACTOR)	{ARITHMETICTERM -> ARITHMETICFACTOR.}	31	 
goto(55, NumInt)	{ARITHMETICFACTOR -> NumInt.}	32	 
goto(55, NumReal)	{ARITHMETICFACTOR -> NumReal.}	33	 
goto(55, Var)	{ARITHMETICFACTOR -> Var.}	34	 
goto(55, OpenPar)	{ARITHMETICFACTOR -> OpenPar.ARITHMETICEXPRESSION ClosePar}	35	 
goto(56, ClosePar)	{RELATIONALTERM -> OpenPar RELATIONALEXPRESSION ClosePar.}	69	{RELATIONALTERM -> OpenPar RELATIONALEXPRESSION ClosePar.}
goto(56, BOOLEANOPERATOR)	{RELATIONALEXPRESSION -> RELATIONALEXPRESSION BOOLEANOPERATOR.RELATIONALTERM}	52	 
goto(56, OpBoolAnd)	{BOOLEANOPERATOR -> OpBoolAnd.}	53	 
goto(56, OpBoolOr)	{BOOLEANOPERATOR -> OpBoolOr.}	54	 
goto(57, ClosePar)	{ARITHMETICFACTOR -> OpenPar ARITHMETICEXPRESSION ClosePar.}	65	 
goto(57, OpAritSum)	{ARITHMETICEXPRESSION -> ARITHMETICEXPRESSION OpAritSum.ARITHMETICTERM}	46	 
goto(57, OpAritSub)	{ARITHMETICEXPRESSION -> ARITHMETICEXPRESSION OpAritSub.ARITHMETICTERM}	47	 
goto(57, OpRel)	{RELATIONALTERM -> ARITHMETICEXPRESSION OpRel.ARITHMETICEXPRESSION}	55	 
goto(61, OpAritMult)	{ARITHMETICTERM -> ARITHMETICTERM OpAritMult.ARITHMETICFACTOR}	48	 
goto(61, OpAritDiv)	{ARITHMETICTERM -> ARITHMETICTERM OpAritDiv.ARITHMETICFACTOR}	49	 
goto(62, OpAritMult)	{ARITHMETICTERM -> ARITHMETICTERM OpAritMult.ARITHMETICFACTOR}	48	 
goto(62, OpAritDiv)	{ARITHMETICTERM -> ARITHMETICTERM OpAritDiv.ARITHMETICFACTOR}	49	 
goto(66, KwElse)	{CONDITIONCMD -> KwIf RELATIONALEXPRESSION KwThen COMMAND KwElse.COMMAND}	70	{CONDITIONCMD -> KwIf RELATIONALEXPRESSION KwThen COMMAND KwElse.COMMAND; COMMAND -> .ASSIGNCMD; COMMAND -> .INCMD; COMMAND -> .OUTCMD; COMMAND -> .CONDITIONCMD; COMMAND -> .REPEATCMD; COMMAND -> .SUBALGORITHM; ASSIGNCMD -> .KwAssign ARITHMETICEXPRESSION KwTo Var; INCMD -> .KwRead Var; OUTCMD -> .KwPrint Var; OUTCMD -> .KwPrint String; CONDITIONCMD -> .KwIf RELATIONALEXPRESSION KwThen COMMAND; CONDITIONCMD -> .KwIf RELATIONALEXPRESSION KwThen COMMAND KwElse COMMAND; REPEATCMD -> .KwWhile RELATIONALEXPRESSION COMMAND; SUBALGORITHM -> .KwBegin COMMANDLIST KwEnd}
goto(68, OpAritSum)	{ARITHMETICEXPRESSION -> ARITHMETICEXPRESSION OpAritSum.ARITHMETICTERM}	46	 
goto(68, OpAritSub)	{ARITHMETICEXPRESSION -> ARITHMETICEXPRESSION OpAritSub.ARITHMETICTERM}	47	 
goto(70, COMMAND)	{CONDITIONCMD -> KwIf RELATIONALEXPRESSION KwThen COMMAND KwElse COMMAND.}	71	{CONDITIONCMD -> KwIf RELATIONALEXPRESSION KwThen COMMAND KwElse COMMAND.}
goto(70, ASSIGNCMD)	{COMMAND -> ASSIGNCMD.}	16	 
goto(70, INCMD)	{COMMAND -> INCMD.}	17	 
goto(70, OUTCMD)	{COMMAND -> OUTCMD.}	18	 
goto(70, CONDITIONCMD)	{COMMAND -> CONDITIONCMD.}	19	 
goto(70, REPEATCMD)	{COMMAND -> REPEATCMD.}	20	 
goto(70, SUBALGORITHM)	{COMMAND -> SUBALGORITHM.}	21	 
goto(70, KwAssign)	{ASSIGNCMD -> KwAssign.ARITHMETICEXPRESSION KwTo Var}	22	 
goto(70, KwRead)	{INCMD -> KwRead.Var}	23	 
goto(70, KwPrint)	{OUTCMD -> KwPrint.Var; OUTCMD -> KwPrint.String}	24	 
goto(70, KwIf)	{CONDITIONCMD -> KwIf.RELATIONALEXPRESSION KwThen COMMAND; CONDITIONCMD -> KwIf.RELATIONALEXPRESSION KwThen COMMAND KwElse COMMAND}	25	 
goto(70, KwWhile)	{REPEATCMD -> KwWhile.RELATIONALEXPRESSION COMMAND}	26	 
goto(70, KwBegin)	{SUBALGORITHM -> KwBegin.COMMANDLIST KwEnd}	27	 